##########
#S......#
#..####.#
#.......#
##########
