############
#S.........#
#..###.....#
#..#.#.....#
#..#.#.....#
#..#.......#
############