{
    "levels": [
        {
            "ascii": [
                "############",
                "#..........#",
                "#......O.C.#",
                "#CO........#",
                "#.....#.S..#",
                "#..C..#....#",
                "#....###....",
                "#.....#....#",
                "#..........#",
                "#..........#",
                "#..........#",
                "######.#####"
            ],
            "name": "combined_12x12_lvl1"
        },
        {
            "ascii": [
                "#############",
                "#.CC........#",
                "#..O........#",
                "#.O....OC...#",
                "#...........#",
                "#..C.C#.....#",
                "#....O##...##",
                "#..C..#.....#",
                "#...........#",
                "#.......S...#",
                "#...........#",
                "#...........#",
                "#############"
            ],
            "name": "combined_13x13_lvl2"
        },
        {
            "ascii": [
                "##############",
                "#.C..O..C..O.#",
                "#..O....C....#",
                "#...C...S....#",
                "#.O.O.......C#",
                "#......#C...C#",
                "#.C....#.....#",
                "#...#####...##",
                "#......#.....#",
                "#.....C......#",
                "#............#",
                "#............#",
                "#............#",
                "##############"
            ],
            "name": "combined_14x14_lvl3"
        },
        {
            "ascii": [
                "###############",
                "#C.........C..#",
                "#..O..C.C...CO#",
                "#O........O...#",
                "#...C.........#",
                "#......OS....C#",
                "#O.....#.C....#",
                "#...#####...###",
                "#......#......#",
                "#.....C.O.....#",
                "#...C.........#",
                "#.............#",
                "#......#......#",
                "#......#......#",
                "###############"
            ],
            "name": "combined_15x15_lvl4"
        },
        {
            "ascii": [
                "################",
                "#.OCOOC....C...#",
                "#..O.C.C..O....#",
                "#..O.C...C.....#",
                "#...C...#O..O..#",
                "#.CC..O.#......#",
                "#.......#.....C#",
                "#.....O.#......#",
                "#...######...###",
                "#.......#......#",
                "#.CC...........#",
                "#.........C....#",
                "#..............#",
                "#.......#......#",
                "#.......#S.....#",
                "################"
            ],
            "name": "combined_16x16_lvl5"
        },
        {
            "ascii": [
                "#################",
                "#..O.......C.C..#",
                "#.O..C.C...O....#",
                "#.O....O.....OC.#",
                "#.......#.CC...C#",
                "#.....C.OO...OC.#",
                "#.......#.O.....#",
                "#.C.....#...O...#",
                "#...###C##....###",
                "#.......#.S.....#",
                "#....O........CC#",
                "#...............#",
                "#...............#",
                "#.......#.......#",
                "#.......#.......#",
                "#.......#.......#",
                "#################"
            ],
            "name": "combined_17x17_lvl6"
        },
        {
            "ascii": [
                "##################",
                "#C...C..C.......O#",
                "#..COO...........#",
                "#.....C..........#",
                "#.C......#O..C...#",
                "#......C.#O....S.#",
                "#.OC.....#...O...#",
                "#...CC...#.....O.#",
                "#.C......#.......#",
                "##....######....O#",
                "#....O...#O...C.C#",
                "#......O.#..C.C.C#",
                "#....C...#......O#",
                "#C.O.............#",
                "#................#",
                "#................#",
                "#........#.......#",
                "##################"
            ],
            "name": "combined_18x18_lvl7"
        },
        {
            "ascii": [
                "###################",
                "#C.......#C...C..O#",
                "#..C..C..#OC....S.#",
                "#....C.C.......C..#",
                "#...O..C.....COC..#",
                "#.C.CO........C.O.#",
                "#........#..CO....#",
                "#........#...O....#",
                "#.......C#.O......#",
                "##....##OC##....###",
                "#O.......#........#",
                "#..O.....#....C...#",
                "#.....O....O......#",
                "#.O...............#",
                "#......O..........#",
                "#.................#",
                "#........#........#",
                "#........#........#",
                "###################"
            ],
            "name": "combined_19x19_lvl8"
        },
        {
            "ascii": [
                "####################",
                "#...C..C.O#.C....C.#",
                "#.OC...........O...#",
                "#...C..............#",
                "#....C..........CO.#",
                "#.....C...#..O.....#",
                "#.....O...#...O.CC.#",
                "#...C.C...#.C.O.C..#",
                "#.........#........#",
                "#....OCC..#........#",
                "##C#...######...#C##",
                "#.....C...#........#",
                "#......O..#......OO#",
                "#.C..O.......S..O..#",
                "#O.....OC..O..C....#",
                "#...........O......#",
                "#.........#........#",
                "#.........#........#",
                "#.........#........#",
                "####################"
            ],
            "name": "combined_20x20_lvl9"
        },
        {
            "ascii": [
                "#####################",
                "#CC.CO....#.O..O.C..#",
                "#..C.......C.C.....C#",
                "#..C..OOC..C.C..COC.#",
                "#....OC..C..O....C.O#",
                "#.O.......#.....O...#",
                "#..O......#.O......C#",
                "#.........#.........#",
                "#...C...OO#.........#",
                "#O........#......C.C#",
                "##...###C#C##...#####",
                "#.O.......#.....C...#",
                "#.........#.........#",
                "#..O......#.........#",
                "#.........#O........#",
                "#........C..........#",
                "#.............C.....#",
                "#...................#",
                "#.........#.........#",
                "#.S.......#.........#",
                "#####################"
            ],
            "name": "combined_21x21_lvl10"
        },
        {
            "ascii": [
                "######################",
                "#........O.OC...O.O.O#",
                "#C....CO.CC#C..O.....#",
                "#...C.....O..........#",
                "#.....C..........O...#",
                "#C......S............#",
                "#.O.C.C..O.#O..CC.CC.#",
                "#C.........#C.....O..#",
                "#..O.......#..C......#",
                "#..O.....C.C.........#",
                "#O....C....#.O.....C.#",
                "#####...#O##C...######",
                "#..........#.........#",
                "#O.....O...C.........#",
                "#..........#......C..#",
                "#.........C..........#",
                "#.......C............#",
                "#....................#",
                "#..........#.........#",
                "#..........#.........#",
                "#..........#.........#",
                "######################"
            ],
            "name": "combined_22x22_lvl11"
        },
        {
            "ascii": [
                "#######################",
                "#C.OO......#..........#",
                "#....C...CC#........CC#",
                "#.CC.C..CCC.....C.C.C.#",
                "#...............O.O...#",
                "#..O......O.........C.#",
                "#......C...#.......C..#",
                "#O....C.SC.#.........C#",
                "#........C.#..OO...O..#",
                "#.O..C.O.C.#....C.....#",
                "#.OO...OO..C.....OO...#",
                "#...############...####",
                "#C.........#..O..O..O.#",
                "#....C.....#..C.......#",
                "#..........OO..C.C....#",
                "#..........#..........#",
                "#..........#..........#",
                "#.....................#",
                "#.....C.C.............#",
                "#.....................#",
                "#..........#..........#",
                "#..........#..........#",
                "#######################"
            ],
            "name": "combined_23x23_lvl12"
        },
        {
            "ascii": [
                "########################",
                "#OC.C.O....CC....OCOC..#",
                "#C....O..OC.#..OO..O...#",
                "#...OC.....C#......O..O#",
                "#.........OO#........C.#",
                "#.O...C...C.#CO.....C..#",
                "#.C..........C....CCC..#",
                "#....C....C............#",
                "#C...O.........OC......#",
                "#...CC..C...#.......C..#",
                "#....C......#.........O#",
                "#....O.....C#.......O..#",
                "####...#####O##...######",
                "#O..........#..........#",
                "#...........#....O.....#",
                "#...........#..........#",
                "#..O........#..........#",
                "#...........#...O......#",
                "#.....C..S..#..........#",
                "#......................#",
                "#......................#",
                "#......................#",
                "#...........#..........#",
                "########################"
            ],
            "name": "combined_24x24_lvl13"
        }
    ],
    "tileset": {
        "#": {
            "asset": "wall",
            "done_on_collision": true
        },
        "C": {
            "asset": "cube",
            "done_on_collision": true,
            "rand_x": 50.0,
            "rand_y": 1.2,
            "rand_z": 0.3,
            "rand_rot_z": 6.28318,
            "rand_scale": 0.4
        },
        "O": {
            "asset": "cylinder",
            "done_on_collision": true,
            "rand_x": 50.0,
            "rand_y": 1.0,
            "rand_z": 0.2,
            "rand_rot_z": 6.28318,
            "rand_scale": 0.3
        },
        "S": {
            "asset": "spawn",
            "rand_x": 0.5,
            "rand_y": 0.5,
            "rand_z": 0.0,
            "rand_rot_z": 0.0
        },
        ".": {
            "asset": "empty"
        }
    },
    "scale": 2.5,
    "auto_boundary_walls": false,
    "spawn_random": true,
    "targets": [
        {
            "position": [
                0.0,
                0.0,
                1.0
            ],
            "motion_type": "static",
            "params": {
                "omega_x": 0.0,
                "omega_y": 1.0,
                "center": [
                    0.0,
                    0.0,
                    1.0
                ],
                "mass": 1.0,
                "phase_x": 0.0,
                "phase_y": 0.0
            }
        }
    ],
    "name": "combined_progression_12x12_to_24x24_spawn_random"
}