########
#S.....#
#......#
#......#
########