{
    "levels": [
        {
            "ascii": [
                "############",
                "#..........#",
                "#.....S....#",
                "#..........#",
                "#..........#",
                "#..........#",
                "#..........#",
                "#..........#",
                "#..........#",
                "#..........#",
                "#..........#",
                "############"
            ],
            "name": "empty_room_12x12_lvl1"
        },
        {
            "ascii": [
                "#############",
                "#...........#",
                "#...........#",
                "#...........#",
                "#...........#",
                "#.....S.....#",
                "#...........#",
                "#...........#",
                "#...........#",
                "#...........#",
                "#...........#",
                "#...........#",
                "#############"
            ],
            "name": "empty_room_13x13_lvl2"
        },
        {
            "ascii": [
                "##############",
                "#............#",
                "#....S.......#",
                "#............#",
                "#............#",
                "#............#",
                "#............#",
                "#............#",
                "#............#",
                "#............#",
                "#............#",
                "#............#",
                "#............#",
                "##############"
            ],
            "name": "empty_room_14x14_lvl3"
        },
        {
            "ascii": [
                "###############",
                "#.............#",
                "#.............#",
                "#.............#",
                "#.............#",
                "#.............#",
                "#.............#",
                "#.............#",
                "#.............#",
                "#.............#",
                "#......S......#",
                "#.............#",
                "#.............#",
                "#.............#",
                "###############"
            ],
            "name": "empty_room_15x15_lvl4"
        },
        {
            "ascii": [
                "################",
                "#..............#",
                "#..............#",
                "#..............#",
                "#..............#",
                "#..............#",
                "#..............#",
                "#..............#",
                "#........S.....#",
                "#..............#",
                "#..............#",
                "#..............#",
                "#..............#",
                "#..............#",
                "#..............#",
                "################"
            ],
            "name": "empty_room_16x16_lvl5"
        },
        {
            "ascii": [
                "#################",
                "#...............#",
                "#...............#",
                "#...............#",
                "#...............#",
                "#.S.............#",
                "#...............#",
                "#...............#",
                "#...............#",
                "#...............#",
                "#...............#",
                "#...............#",
                "#...............#",
                "#...............#",
                "#...............#",
                "#...............#",
                "#################"
            ],
            "name": "empty_room_17x17_lvl6"
        },
        {
            "ascii": [
                "##################",
                "#................#",
                "#................#",
                "#................#",
                "#................#",
                "#................#",
                "#................#",
                "#................#",
                "#................#",
                "#................#",
                "#................#",
                "#................#",
                "#................#",
                "#................#",
                "#................#",
                "#...........S....#",
                "#................#",
                "##################"
            ],
            "name": "empty_room_18x18_lvl7"
        },
        {
            "ascii": [
                "###################",
                "#.................#",
                "#.S...............#",
                "#.................#",
                "#.................#",
                "#.................#",
                "#.................#",
                "#.................#",
                "#.................#",
                "#.................#",
                "#.................#",
                "#.................#",
                "#.................#",
                "#.................#",
                "#.................#",
                "#.................#",
                "#.................#",
                "#.................#",
                "###################"
            ],
            "name": "empty_room_19x19_lvl8"
        },
        {
            "ascii": [
                "####################",
                "#..................#",
                "#..................#",
                "#..................#",
                "#..................#",
                "#..................#",
                "#..................#",
                "#..................#",
                "#..................#",
                "#..................#",
                "#..................#",
                "#...............S..#",
                "#..................#",
                "#..................#",
                "#..................#",
                "#..................#",
                "#..................#",
                "#..................#",
                "#..................#",
                "####################"
            ],
            "name": "empty_room_20x20_lvl9"
        },
        {
            "ascii": [
                "#####################",
                "#...................#",
                "#...................#",
                "#...................#",
                "#...................#",
                "#...................#",
                "#...................#",
                "#...................#",
                "#...................#",
                "#...................#",
                "#...................#",
                "#...................#",
                "#...................#",
                "#...................#",
                "#...................#",
                "#............S......#",
                "#...................#",
                "#...................#",
                "#...................#",
                "#...................#",
                "#####################"
            ],
            "name": "empty_room_21x21_lvl10"
        },
        {
            "ascii": [
                "######################",
                "#....................#",
                "#....................#",
                "#....................#",
                "#....................#",
                "#....................#",
                "#....................#",
                "#....................#",
                "#....................#",
                "#....................#",
                "#....................#",
                "#....................#",
                "#....................#",
                "#....................#",
                "#....................#",
                "#....................#",
                "#....................#",
                "#....................#",
                "#......S.............#",
                "#....................#",
                "#....................#",
                "######################"
            ],
            "name": "empty_room_22x22_lvl11"
        },
        {
            "ascii": [
                "#######################",
                "#.....................#",
                "#.....................#",
                "#.....................#",
                "#.....................#",
                "#.....................#",
                "#.....................#",
                "#................S....#",
                "#.....................#",
                "#.....................#",
                "#.....................#",
                "#.....................#",
                "#.....................#",
                "#.....................#",
                "#.....................#",
                "#.....................#",
                "#.....................#",
                "#.....................#",
                "#.....................#",
                "#.....................#",
                "#.....................#",
                "#.....................#",
                "#######################"
            ],
            "name": "empty_room_23x23_lvl12"
        },
        {
            "ascii": [
                "########################",
                "#......................#",
                "#......................#",
                "#......................#",
                "#......................#",
                "#......................#",
                "#......................#",
                "#......................#",
                "#......................#",
                "#..............S.......#",
                "#......................#",
                "#......................#",
                "#......................#",
                "#......................#",
                "#......................#",
                "#......................#",
                "#......................#",
                "#......................#",
                "#......................#",
                "#......................#",
                "#......................#",
                "#......................#",
                "#......................#",
                "########################"
            ],
            "name": "empty_room_24x24_lvl13"
        }
    ],
    "tileset": {
        "#": {
            "asset": "wall",
            "done_on_collision": true
        },
        "S": {
            "asset": "spawn"
        },
        ".": {
            "asset": "empty"
        }
    },
    "scale": 2.5,
    "auto_boundary_walls": false,
    "spawn_random": true,
    "targets": [
        {
            "position": [
                0.0,
                0.0,
                1.0
            ],
            "motion_type": "static",
            "params": {
                "omega_x": 0.0,
                "omega_y": 1.0,
                "center": [
                    0.0,
                    0.0,
                    1.0
                ],
                "mass": 1.0,
                "phase_x": 0.0,
                "phase_y": 0.0
            }
        }
    ],
    "name": "empty_room_progression_12x12_to_24x24_spawn_random"
}