{
  "ascii": [
    "##########################",
    "#........................#",
    "#........................#",
    "#........................#",
    "#........................#",
    "#........................#",
    "#........................#",
    "#........................#",
    "#........................#",
    "#........................#",
    "#........................#",
    "#........................#",
    "#............S...........#",
    "#........................#",
    "#........................#",
    "#........................#",
    "#........................#",
    "#........................#",
    "#........................#",
    "#........................#",
    "#........................#",
    "#........................#",
    "#........................#",
    "#........................#",
    "#........................#",
    "##########################"
  ],
  "tileset": {
    "#": {"asset": "wall"},
    "S": {"asset": "spawn"},
    ".": {"asset": "empty"}
  },
  "targets": [
    {
      "position": [5.0, 2.5, 1.5],
      "motion_type": "figure8",
      "params": {
        "omega_x": 1.0,
        "omega_y": 6.0,
        "center": [0.0, 0.0, 1.5],
        "mass": 1.0,
        "phase_x": 20.0,
        "phase_y": 20.0
      }
    }
  ]
}