{
    "ascii": [
        "######################",
        "#....................#",
        "#....................#",
        "#....................#",
        "#....................#",
        "#.........S..........#",
        "#....................#",
        "#....................#",
        "#....................#",
        "#....................#",
        "######################"
    ],
    "tileset": {
        "#": {"asset": "wall"},
        "S": {"asset": "spawn"},
        ".": {"asset": "empty"}
    },
    "lidar_num_samples": 64,
    "lidar_fov_degrees": 360.0,
    "name": "64_beam_360_degree_lidar"
}
