{
    "ascii": [
        "####################",
        "#..................#",
        "#..C...............#",
        "#....C.....O.......#",
        "#..................#",
        "#..................#",
        "#.........O........#",
        "#..................#",
        "#........C.........#",
        "#..O...............#",
        "#..................#",
        "#..........C.......#",
        "#..................#",
        "#..................#",
        "#......C...........#",
        "#......O...........#",
        "#..................#",
        "#..................#",
        "#..................#",
        "#..............O...#",
        "#.......C..........#",
        "#..................#",
        "#..................#",
        "#..C...............#",
        "#..................#",
        "#..................#",
        "#..........O.......#",
        "#..................#",
        "#..................#",
        "#.............O....#",
        "#..................#",
        "#..............C...#",
        "#..................#",
        "#..................#",
        "#........C.........#",
        "#..................#",
        "#..................#",
        "#..................#",
        "#...O..............#",
        "#..................#",
        "#...........O......#",
        "#..................#",
        "#..................#",
        "#......C...........#",
        "#..................#",
        "#..................#",
        "#..................#",
        "#.........S........#",
        "#..................#",
        "####################"
    ],
    "tileset": {
        "#": {
            "asset": "wall",
            "done_on_collision": true
        },
        "C": {
            "asset": "cube",
            "done_on_collision": true,
            "rand_x": 0.8,
            "rand_y": 0.8,
            "rand_z": 0.0,
            "rand_rot_z": 3.14159
        },
        "O": {
            "asset": "cylinder",
            "done_on_collision": true,
            "rand_x": 0.6,
            "rand_y": 0.6,
            "rand_z": 0.0,
            "rand_rot_z": 0.0
        },
        "S": {
            "asset": "spawn",
            "rand_x": 0.5,
            "rand_y": 0.5,
            "rand_z": 0.0,
            "rand_rot_z": 0.0
        },
        ".": {
            "asset": "empty"
        }
    },
    "scale": 3.0,
    "agent_facing": [
        0
    ],
    "name": "lvl3_20x48"
}