{
    "ascii": [
        "###################",
        "#........O........#",
        "#........O........#",
        "#........O........#",
        "#........O........#",
        "#........C........#",
        "#........O........#",
        "#........O........#",
        "#........O........#",
        "#........C........#",
        "#........C........#",
        "#........C........#",
        "#........C........#",
        "#........C........#",
        "#.................#",
        "#.................#",
        "#.................#",
        "#........C........#",
        "#........C........#",
        "#.................#",
        "#........O........#",
        "#.................#",
        "#.................#",
        "#........C........#",
        "#........C........#",
        "#.................#",
        "#........O........#",
        "#........O........#",
        "#.................#",
        "#.................#",
        "#.................#",
        "#........O........#",
        "#.................#",
        "#.................#",
        "#.................#",
        "#........C........#",
        "#.................#",
        "#........O........#",
        "#.................#",
        "#........C........#",
        "#.................#",
        "#........O........#",
        "#........O........#",
        "#.................#",
        "#.................#",
        "#.................#",
        "#........S........#",
        "###################"
    ],
    "tileset": {
        "#": {
            "asset": "wall",
            "done_on_collision": true
        },
        "C": {
            "asset": "cube",
            "done_on_collision": true,
            "rand_x": 50.0,
            "rand_y": 1.2,
            "rand_z": 0.3,
            "rand_rot_z": 6.28318,
            "rand_scale": 0.4
        },
        "O": {
            "asset": "cylinder",
            "done_on_collision": true,
            "rand_x": 50.0,
            "rand_y": 1.0,
            "rand_z": 0.2,
            "rand_rot_z": 6.28318,
            "rand_scale": 0.3
        },
        "S": {
            "asset": "spawn",
            "rand_x": 0.5,
            "rand_y": 0.5,
            "rand_z": 0.0,
            "rand_rot_z": 0.0
        },
        ".": {
            "asset": "empty"
        }
    },
    "scale": 3.0,
    "agent_facing": [
        0
    ],
    "name": "lvl4_19x48_gen"
}