##########
#S.......#
#........#
#........#
#........#
#........#
##########