{
  "ascii": [
    "################################",
    "#..............................#",
    "#..............................#",
    "#..............................#",
    "#..............................#",
    "#..............................#",
    "#..............................#",
    "#..............................#",
    "#..............................#",
    "#..............................#",
    "#..............................#",
    "#..............................#",
    "#..............................#",
    "#..............................#",
    "#..............S...............#",
    "#..............................#",
    "#..............................#",
    "#..............................#",
    "#..............................#",
    "#..............................#",
    "#..............................#",
    "#..............................#",
    "#..............................#",
    "#..............................#",
    "#..............................#",
    "#..............................#",
    "#..............................#",
    "#..............................#",
    "#..............................#",
    "#..............................#",
    "#..............................#",
    "################################"
  ],
  "tileset": {
    "#": {"asset": "wall"},
    "S": {"asset": "spawn"},
    ".": {"asset": "empty"}
  },
  "targets": [
    {
      "position": [10.0, 20.0, 1.0],
      "motion_type": "static"
    },
    {
      "position": [-15.0, 10.0, 1.0],
      "motion_type": "static"
    },
    {
      "position": [25.0, -5.0, 1.0],
      "motion_type": "static"
    },
    {
      "position": [-20.0, -15.0, 1.0],
      "motion_type": "static"
    },
    {
      "position": [0.0, 30.0, 1.0],
      "motion_type": "static"
    }
  ]
}