{
  "ascii": [
    ".............................",
    ".....C..................C...",
    "..........C..............C..",
    "..C......................C..",
    "....................C.......",
    "........C................C..",
    "........................C...",
    "...C...................C...",
    ".................C..........",
    "......C.....................",
    ".........................C..",
    ".....................C......",
    "..C.........................",
    "...................C........",
    "..............S.............",
    ".........C..................",
    "..........................C.",
    "..C.........................",
    ".....................C......",
    ".........................C..",
    "......C.....................",
    ".................C..........",
    "...C........................",
    "........................C...",
    "........C...................",
    "....................C.......",
    "..C.........................",
    "..........C.................",
    ".....C......................"
  ],
  "tileset": {
    "S": {"asset": "spawn"},
    "C": {"asset": "cube"},
    ".": {"asset": "empty"}
  },
  "auto_boundary_walls": true,
  "targets": [
    {
      "position": [10.0, 20.0, 1.0],
      "motion_type": "static"
    },
    {
      "position": [-15.0, 10.0, 1.0],
      "motion_type": "static"
    },
    {
      "position": [25.0, -5.0, 1.0],
      "motion_type": "static"
    },
    {
      "position": [-20.0, -15.0, 1.0],
      "motion_type": "static"
    }
  ]
}